NO ./texture/nether0.xpm
SO ./texture/nether1.xpm
WE ./texture/nether2.xpm
EA ./texture/nether3.xpm
CT ./texture/merge_sky.xpm
FT ./texture/floor.xpm



1111111111111111111111111111111
1000000000000000000000000000001
1111000011100000000111000011111
1111000011100000000111000011111
1000000000000000000000000000001
1111000011100000000111000011111
1111000011100000000111000011111
1000000000000000000000000000001
1111000011100000000111000011111
11110000111000N0000111000011111
1000000000000000000000000000001
1111000011100000000111000011111
1111000011100000000111000011111
1000000000000000000000000000001
1111000011100000000111000011111
1111000011100000000111000011111
1111111111111111111111111111111
