NO ./texture/nether0.xpm
SO ./texture/nether1.xpm
WE ./texture/nether2.xpm
EA ./texture/nether3.xpm
CT ./texture/merge_sky.xpm
FT ./texture/floor.xpm


111111111111111111111111111111111111111111111111111111111111111111111111111111111111111111111111111111111111111111111111111111111111111111111111111111111111111111111111111111111111111111111111111111111111111111111111111111111111111111111111111111111111111111111111111111111111111111111111111111111111111111111111111111111111111111111111111111111111111111111111111111111111111111111111111111111111111111111111111111111111111111111111111111111111111111111111111111111111111111111111111111111111111111111111111111111111111111111111111111111111111111111111111111111111111111111111111111111111111111111111111111111111111111111111111111111111111111111111111111111111111111111111111111111111111111111111111111111111111111111111111111111111111111111111111111111111111111111111111111111111111111111111111111111111111111111111111111111111111111111111111111111111111111111111111111111111111111111111111111111111111111111111111111111111111111111111111111111111111111111111111111111111111111111111
100001010101010101010101010101010101010101010101010101010101010101010101010101010101010101010101010101010101010101010101010101010101010010101010101010101010101010101010101010101010101010100101010101010101010101010101010101010101010101010101001010101010101010101010101010101010101010101010101010010101010101010101010101010101010101010101010101010100101010101010101010101010101010101010101010101010101001010101010101010101010101010101010101010101010101010010101010101010101010101010101010101010101010101010100101010101010101010101010101010101010101010101010101001010101010101010101010101010101010101010101010101010010101010101010101010101010101010101010101010101010100101010101010101010101010101010101010101010101010101001010101010101010101010101010101010101010101010101010010101010101010101010101010101010101010101010101010100101010101010101010101010101010101010101010101010101001010101010101010101010101010101010101010101010101010010101010101010101010101010101010101010101010101010101
10N000000000000000000000000000000000000000000000000000000000000000000000000000000000000000000000000000000000000000000000000000000000000000000000000000000000000000000000000000000000000000000000000000000000000000000000000000000000000000000000000000000000000000000000000000000000000000000000000000000000000000000000000000000000000000000000000000000000000000000000000000000000000000000000000000000000000000000000000000000000000000000000000000000000000000000000000000000000000000000000000000000000000000000000000000000000000000000000000000000000000000000000000000000000000000000000000000000000000000000000000000000000000000000000000000000000000000000000000000000000000000000000000000000000000000000000000000000000000000000000000000000000000000000000000000000000000000000000000000000000000000000000000000000000000000000000000000000000000000000000000000000000000000000000000000000000000000000000000000000000000000000000000000000000000000000000000000000000000000000000000000000000000000000001
100000101010101010101010101010101010101010101010101010101010101010101010101010101010101010101010101010101010101010101010101010101010101101010101010101010101010101010101010101010101010101011010101010101010101010101010101010101010101010101010110101010101010101010101010101010101010101010101010101101010101010101010101010101010101010101010101010101011010101010101010101010101010101010101010101010101010110101010101010101010101010101010101010101010101010101101010101010101010101010101010101010101010101010101011010101010101010101010101010101010101010101010101010110101010101010101010101010101010101010101010101010101101010101010101010101010101010101010101010101010101011010101010101010101010101010101010101010101010101010110101010101010101010101010101010101010101010101010101101010101010101010101010101010101010101010101010101011010101010101010101010101010101010101010101010101010110101010101010101010101010101010101010101010101010101101010101010101010101010101010101010101010101010101011
111111111111111111111111111111111111111111111111111111111111111111111111111111111111111111111111111111111111111111111111111111111111111111111111111111111111111111111111111111111111111111111111111111111111111111111111111111111111111111111111111111111111111111111111111111111111111111111111111111111111111111111111111111111111111111111111111111111111111111111111111111111111111111111111111111111111111111111111111111111111111111111111111111111111111111111111111111111111111111111111111111111111111111111111111111111111111111111111111111111111111111111111111111111111111111111111111111111111111111111111111111111111111111111111111111111111111111111111111111111111111111111111111111111111111111111111111111111111111111111111111111111111111111111111111111111111111111111111111111111111111111111111111111111111111111111111111111111111111111111111111111111111111111111111111111111111111111111111111111111111111111111111111111111111111111111111111111111111111111111111111111111111111111111111
