NO ./texture/nether0.xpm
SO ./texture/nether1.xpm
WE ./texture/nether2.xpm
EA ./texture/nether3.xpm
F 40,20,0
C 2,100,22

111111111111111
100000000000001
100000000000001
100000000000001
1000000N0000001
100000000000001
100000000000001
100000111000001
100000000000001
111111111111111
