NO ./texture/crystal.xpm
SO ./texture/crystal_imac.xpm
WE ./texture/crystal_box.xpm
EA ./texture/crystal_sign.xpm
F 0,0,0
C 0,0,0

11111111111111111111111111111111111111111111111111111111111111111111111111111111
10000010000000100000001000001000000000100000000000100000100000000010000000100011
11101011111010111011101110111011111010111011111110101111101111111010111011101011
10001000100010001000100010000010100010000010100010100000000000100010101000001011
10111110101111101110111011111010101111111110101010111111111111101110101111111011
10001010100010100000100010001010101000100000001000100000100000100000000010001011
11101010101010111111101110101010101010111011111111101110101110101111111110101011
10101000101010100000100000101000100010001000000010000010001000101000000010100011
10111011101010101110111111101111111111101111111010111011111011111011111010111011
10001000101010001010000000001000000000001000100010100010000010000010100010001011
10101110111011101011111111111011111111111010101111101111101110111110101110101011
10100010001000101000000000000000001000100010100000100000101000100000101010101011
10101111101110101111101111111111101011101011111110111110101011101111101010101111
10101000101000100000100010001000001010001000000010000010100010100000101000100011
10101010101011111110101110101011111010111110111111111010111110101110101011111011
10100010001000100000101000101000001000001010000000001000100010001010001000100011
10111111111110101111111011101111101111101011111011101111101110111011111110101111
10001000000010101000100010001000001000100000100010101000001000100010000000100011
11101011111010101010101110111011111010111111101110101010111011101010111111111011
1000100000100010101000100000101000E010000010001000001010001010001010000000101011
10111011101111101011111111101010111111111010111111111011101010111011111110101011
10001000100010001000100010101010000000001000100000100010101000101010100000001011
11101011111010111110101010101010111111101011101110101110101111101010101111111011
10001010000010000010001010100010100000101010001010101000100000100010001000000011
10111010111111111010111010111110101011101010111010101011111011101110111011111111
10001010001010000010101010000010101000101010001010001000001010001000101010000011
11101011101010111110101010101110111110101111101011111110111010111011101010111011
10101010001000100010101010100010000000100000001000100000100010001010001000100011
10101010111011101010101011111011111110111111111010101110101111101011101111101111
10001010100010001010001000001000000010001000000010001000100000101000001000100011
10111010101110111011111110101011111011101110111111111011111110101111101010111011
10001010100010101000000010101010001000001000100010000010001000100010001010100011
11101010111010101111111011101010111111111011101010111111101011111011111010101011
10101010100000100000001000001010000010000010001010000000001000000010000010001011
10101010111111111110111111111010111010101111111011111111101111111110111111111011
10101010000010000010100000001010001000101000000000100000101000000000000010000011
10101111111010111010101111101011111111101011111110101110101111101111111010111111
10100000001000001010001000101010000010001010000010101010101000101000100010100011
10111111101111111010111110101010111010111010111011101010101010111010101110101011
10000000000000000010000000100000100000100000001000000010000010000010001000001011
11111111111111111111111111111111111111111111111111111111111111111111111111111111
