
1111111111111111111111111
1000000000100000000000001
1000000001000000000000001
10S0000000000000000000001
1111111111111111111111111
